00000000000000000010000000000000000000
00000000000000000010000000000000000000
00000000000000000000000000000000000000
00000000000000000000000000000000000000
00001110000000000000000000000001110000
00000000000000000000000000000000000000
00000000000000000000000000000000000000
00000000000111000000000011100000000000
00000000000100000000000000100000000000
00000000000000000000000000000000000000
00011000000000000000000000000000011000
00001000000000000000000000000000010000
00001000110000000000000000001100010000
00001000110000000000000000001100010000
00001000000000000000000000000000010000
00001000000000000000000000000000010000
00011000000000000000000000000000011000
00000000000100000000000000100000000000
00000000000111000000000011100000000000
00000000000000000000000000000000000000
00000000000000000000000000000000000000
00000000000000000000000000000000000000
00001110000000000000000000000001110000
00000000000000000000000000000000000000
00000000000000000010000000000000000000
00000000000000000010000000000000000000
