00000000000000001000000000010000000000
00000000000000001000000000010000000000
00000000000000001000000000000000000000
00000000000000001000011000000001110000
00000000000000000000001000000000000000
00011110000000000000001000100000000000
00000100000100000000000000000000000000
00000000000100000000000000000001100001
00000000000000000000000000000001000000
00000000000000000000001100000111000000
11110000000000000000001000000000000000
00000000000111000000001000000000000000
00000000000001000000000000000000000000
00000000000000000000000000000000000000
00000000000000000000000000000111000111
00001111000000000000000000000000000100
00000000000000000000000000000000000000
00000000000000000000000000111000000000
00000000010000000000000000000000010000
00011100010001000000000000000000010000
00000100000001000000000000000000010000
00000000000001100000000000100000000000
00000000000000000010000011100000000000
00000000000000000000000010000000000000
00000001000000000000000000000000001000
00000001000000000000010000000000001000
