00000000000000000000000000000000000000
00000000000000000000000000000000000000
00000000000000000000000000000000000000
00000000000000000011000000000000000000
00000000000000000011000000000000000000
00000000000000000011000000000000000000
00000000000000000011000000000000000000
00000000000000000000000000000000000000
00000000000000000000000000000000000000
00000000000000000000000000000000000000
00011000000000000000000000000000011000
00001000000000000000000000000000010000
00001000111100000000000000111100010000
00001000111100000000000000111100010000
00001000000000000000000000000000010000
00001000000000000000000000000000010000
00011000000000000000000000000000011000
00000000000000000000000000000000000000
00000000000000000000000000000000000000
00000000000000000011000000000000000000
00000000000000000011000000000000000000
00000000000000000011000000000000000000
00000000000000000011000000000000000000
00000000000000000000000000000000000000
00000000000000000000000000000000000000
00000000000000000000000000000000000000
